1111111111
1000011011
10000000C1
111CC000P1
1CCCECCC01
1111111111