111111111111111111
100001101000100001
10000000CCCCC00001
1000C0010000001001
111CC0000P00010001
1CCCECCC0C01000CC1
111111111111111111