111111111111111111
100001100E00100001
1000000C0000C00001
1CC000010000001001
111000000000010001
10000P000001000001
111111111111111111