111111111111111111
100001101000100001
100000000000000001
1000C0010000001001
111000000000010001
1000PE000001000001
111111111111111111