111111111111111111
100001101000100001
100000000000000001
1000C0010000001001
111000000P00010001
10000E000001000001
111111111111111111